resultCode,resultMsg,accDefRate,accExamCnt,accExamCompCnt,careCnt,clearCnt,createDt,deathCnt,decideCnt,examCnt,resutlNegCnt,seq,stateDt,stateTime,updateDt,numOfRows,pageNo,totalCount
0,NORMAL SERVICE.,1.357230437,8059113,7977201,7719,98786,2021-04-09 9:33,1764,108269,81912,7868932,475,20210409,0:00,null,10,1,435
0,NORMAL SERVICE.,1.356090364,8012421,7934427,7480,98360,2021-04-08 9:30,1758,107598,77994,7826829,474,20210408,0:00,null,10,1,435
0,NORMAL SERVICE.,1.354592427,7966167,7891525,7214,97928,2021-04-07 0:00,1756,106898,74642,7784627,473,20210407,0:00,null,10,1,435
0,NORMAL SERVICE.,1.354605602,7921290,7842135,7115,97363,2021-04-06 9:31,1752,106230,79155,7735905,472,20210406,0:00,2021-04-06 19:12,10,1,435
0,NORMAL SERVICE.,1.357827609,7868820,7788323,7104,96900,2021-04-05 9:44,1748,105752,80497,7682571,471,20210405,0:00,null,10,1,435
0,NORMAL SERVICE.,1.354998412,7849476,7769677,6946,96589,2021-04-04 9:45,1744,105279,79799,7664398,470,20210404,0:00,null,10,1,435
0,NORMAL SERVICE.,1.350680582,7829601,7754313,6800,96196,2021-04-03 9:34,1740,104736,75288,7649577,469,20210403,0:00,null,10,1,435
0,NORMAL SERVICE.,1.350079941,7788295,7717543,6595,95861,2021-04-02 9:54,1737,104193,70752,7613350,468,20210402,0:00,2021-04-03 10:07,10,1,435
0,NORMAL SERVICE.,1.349665911,7747300,7678641,6462,95439,2021-04-01 9:32,1735,103636,68659,7575005,467,20210401,0:00,2021-04-02 9:54,10,1,435
0,NORMAL SERVICE.,1.349899398,7707797,7636495,6324,95030,2021-03-31 9:32,1731,103085,71302,7533410,466,20210331,0:00,2021-04-02 14:07,10,1,435
0,NORMAL SERVICE.,1.352290902,7663996,7585572,6287,94563,2021-03-30 9:39,1729,102579,78424,7482993,465,20210330,0:00,2021-04-02 14:07,10,1,435
0,NORMAL SERVICE.,1.355005928,7616322,7537384,6282,94124,2021-03-29 9:41,1726,102132,78938,7435252,463,20210329,0:00,2021-04-02 14:08,10,1,435
0,NORMAL SERVICE.,1.353601391,7595589,7516984,6173,93855,2021-03-28 11:17,1722,101750,78605,7415234,462,20210328,0:00,2021-04-02 14:08,10,1,435
0,NORMAL SERVICE.,1.350710588,7572561,7497387,6072,93475,2021-03-27 9:53,1721,101268,75174,7396119,461,20210327,0:00,2021-04-02 14:08,10,1,435
0,NORMAL SERVICE.,1.352162853,7529396,7451987,6417,92630,2021-03-26 9:33,1716,100763,77409,7351224,460,20210326,0:00,2021-04-02 14:09,10,1,435
0,NORMAL SERVICE.,1.355246941,7485856,7398873,6496,92068,2021-03-25 9:34,1709,100273,86983,7298600,459,20210325,0:00,2021-04-02 14:09,10,1,435
0,NORMAL SERVICE.,1.358984854,7441207,7346881,6576,91560,2021-03-24 9:35,1707,99843,94326,7247038,458,20210324,0:00,2021-04-02 14:09,10,1,435
0,NORMAL SERVICE.,1.361697849,7400984,7300812,6632,91079,2021-03-23 9:32,1704,99415,100172,7201397,457,20210323,0:00,2021-04-02 14:10,10,1,435
0,NORMAL SERVICE.,1.365936533,7355958,7252826,6761,90611,2021-03-22 10:04,1697,99069,103132,7153757,456,20210322,0:00,2021-04-02 14:10,10,1,435
0,NORMAL SERVICE.,1.363680031,7332703,7234395,6630,90328,2021-03-21 9:53,1696,98654,98308,7135741,455,20210321,0:00,2021-04-02 14:56,10,1,435
0,NORMAL SERVICE.,1.360851927,7308939,7215921,6556,89949,2021-03-20 9:31,1693,98198,93018,7117723,454,20210320,0:00,2021-04-02 14:57,10,1,435
0,NORMAL SERVICE.,1.362080675,7264935,7176594,6538,89523,2021-03-19 9:32,1690,97751,88341,7078843,453,20210319,0:00,2021-04-02 14:58,10,1,435
0,NORMAL SERVICE.,1.364802194,7218081,7128359,6422,89178,2021-03-18 9:38,1688,97288,89722,7031071,452,20210318,0:00,2021-04-02 15:00,10,1,435
0,NORMAL SERVICE.,1.366287051,7171504,7088042,6343,88814,2021-03-17 9:31,1686,96843,83462,6991199,451,20210317,0:00,2021-04-02 15:02,10,1,435
0,NORMAL SERVICE.,1.367389767,7126071,7048027,6441,88255,2021-03-16 9:36,1678,96374,78044,6951653,450,20210316,0:00,2021-04-02 15:03,10,1,435
0,NORMAL SERVICE.,1.368976055,7084934,7013344,6582,87754,2021-03-15 9:51,1675,96011,71590,6917333,449,20210315,0:00,2021-04-02 15:04,10,1,435
0,NORMAL SERVICE.,1.366844111,7066398,6996555,6555,87408,2021-03-14 9:42,1669,95632,69843,6900923,448,20210314,0:00,2021-04-02 15:04,10,1,435
0,NORMAL SERVICE.,1.363723965,7046779,6978905,6881,86625,2021-03-13 9:36,1667,95173,67874,6883732,447,20210313,0:00,2021-04-02 15:05,10,1,435
0,NORMAL SERVICE.,1.363537585,7012661,6943923,7278,85743,2021-03-12 9:49,1662,94683,68738,6849240,446,20210312,0:00,2021-04-02 15:06,10,1,435
0,NORMAL SERVICE.,1.363419115,6976982,6908734,7868,84675,2021-03-11 9:39,1652,94195,68248,6814539,445,20210311,0:00,2021-04-02 15:06,10,1,435
0,NORMAL SERVICE.,1.364615192,6938881,6868603,7770,84312,2021-03-10 9:45,1648,93730,70278,6774873,444,20210310,0:00,2021-04-02 15:07,10,1,435
0,NORMAL SERVICE.,1.36495094,6902981,6832480,7715,83900,2021-03-09 9:52,1645,93260,70501,6739220,443,20210309,0:00,2021-04-02 15:16,10,1,435
0,NORMAL SERVICE.,1.366034323,6861806,6794412,7698,83474,2021-03-08 9:31,1642,92814,67394,6701598,442,20210308,0:00,2021-04-02 15:17,10,1,435
0,NORMAL SERVICE.,1.364493508,6843123,6776727,7614,83220,2021-03-07 9:52,1634,92468,66396,6684259,441,20210307,0:00,2021-04-02 15:18,10,1,435
0,NORMAL SERVICE.,1.362367131,6821940,6756769,7507,82913,2021-03-06 9:40,1632,92052,65171,6664717,440,20210306,0:00,2021-04-02 15:18,10,1,435
0,NORMAL SERVICE.,1.362526376,6789008,6725301,7447,82560,2021-03-05 9:41,1627,91634,63707,6633667,439,20210305,0:00,2021-04-02 15:19,10,1,435
0,NORMAL SERVICE.,1.363398352,6751897,6691808,7455,82162,2021-03-04 9:33,1619,91236,60089,6600572,438,20210304,0:00,2021-04-02 15:19,10,1,435
0,NORMAL SERVICE.,1.365525606,6716200,6650333,7500,81700,2021-03-03 9:33,1612,90812,65867,6559521,437,20210303,0:00,2021-04-02 15:19,10,1,435
0,NORMAL SERVICE.,1.367442526,6681973,6608541,7424,81338,2021-03-02 9:32,1606,90368,73432,6518173,436,20210302,0:00,2021-04-02 15:20,10,1,435
0,NORMAL SERVICE.,1.365654097,6665751,6592006,7349,81070,2021-03-01 9:48,1605,90024,73745,6501982,435,20210301,0:00,2021-04-02 15:20,10,1,435
0,NORMAL SERVICE.,1.363556667,6649000,6576111,7369,80697,2021-02-28 10:24,1603,89669,72889,6486442,434,20210228,0:00,2021-04-02 15:20,10,1,435
0,NORMAL SERVICE.,1.361863017,6627211,6558222,7386,80333,2021-02-27 9:37,1595,89314,68989,6468908,433,20210227,0:00,2021-04-02 15:21,10,1,435
0,NORMAL SERVICE.,1.363250762,6590046,6521104,7434,79880,2021-02-26 9:32,1585,88899,68942,6432205,431,20210226,0:00,2021-04-02 15:21,10,1,435
0,NORMAL SERVICE.,1.365391148,6551210,6482538,7444,79487,2021-02-25 9:31,1581,88512,68672,6394026,430,20210225,0:00,2021-04-02 15:24,10,1,435
0,NORMAL SERVICE.,1.369127425,6510985,6435997,7491,79050,2021-02-24 9:33,1576,88117,74988,6347880,429,20210224,0:00,2021-04-02 15:26,10,1,435
0,NORMAL SERVICE.,1.370250726,6472675,6398610,7710,78394,2021-02-23 9:31,1573,87677,74065,6310933,428,20210223,0:00,2021-04-02 15:26,10,1,435
0,NORMAL SERVICE.,1.373688781,6429141,6356680,7872,77887,2021-02-22 9:30,1562,87321,72461,6269359,427,20210222,0:00,2021-04-02 15:26,10,1,435
0,NORMAL SERVICE.,1.372503326,6411337,6337981,7916,77516,2021-02-21 9:34,1557,86989,73356,6250992,426,20210221,0:00,2021-04-02 15:27,10,1,435
0,NORMAL SERVICE.,1.371021037,6390628,6314491,7937,77083,2021-02-20 9:40,1553,86573,76137,6227918,425,20210220,0:00,2021-04-02 15:27,10,1,435
0,NORMAL SERVICE.,1.372537739,6345989,6274873,8062,76513,2021-02-19 9:33,1550,86125,71116,6188748,423,20210219,0:00,2021-04-02 15:27,10,1,435
0,NORMAL SERVICE.,1.372870013,6303211,6232491,8124,75896,2021-02-18 9:31,1544,85564,70720,6146927,422,20210218,0:00,2021-04-02 15:27,10,1,435
0,NORMAL SERVICE.,1.372671074,6260564,6188154,8045,75360,2021-02-17 9:36,1538,84943,72410,6103211,421,20210217,0:00,2021-04-02 15:28,10,1,435
0,NORMAL SERVICE.,1.374085608,6213487,6136590,8237,74551,2021-02-16 9:31,1534,84322,76897,6052268,420,20210216,0:00,2021-04-02 15:31,10,1,435
0,NORMAL SERVICE.,1.378744014,6162856,6082710,8544,73794,2021-02-15 9:32,1527,83865,80146,5998845,419,20210215,0:00,2021-04-02 15:34,10,1,435
0,NORMAL SERVICE.,1.3778227,6140083,6061883,8441,73559,2021-02-14 9:31,1522,83522,78200,5978361,418,20210214,0:00,2021-04-02 15:34,10,1,435
0,NORMAL SERVICE.,1.376259019,6115334,6045083,8455,73227,2021-02-13 10:09,1514,83196,70251,5961887,417,20210213,0:00,2021-04-02 15:33,10,1,435
0,NORMAL SERVICE.,1.377646111,6093363,6012502,8388,72936,2021-02-12 9:31,1507,82831,80861,5929671,416,20210212,0:00,2021-04-02 16:13,10,1,435
0,NORMAL SERVICE.,1.376513324,6070005,5988391,8297,72638,2021-02-11 9:31,1496,82431,81614,5905960,415,20210211,0:00,2021-04-02 16:14,10,1,435
0,NORMAL SERVICE.,1.376937329,6030020,5949944,8215,72226,2021-02-10 9:33,1486,81927,80076,5868017,414,20210210,0:00,2021-04-02 16:13,10,1,435
0,NORMAL SERVICE.,1.379951673,5987402,5904772,8325,71676,2021-02-09 9:31,1482,81483,82630,5823289,413,20210209,0:00,2021-04-02 16:17,10,1,435
0,NORMAL SERVICE.,1.386898338,5938192,5853349,8488,71218,2021-02-08 9:33,1474,81180,84843,5772169,412,20210208,0:00,2021-04-02 16:18,10,1,435
0,NORMAL SERVICE.,1.388413071,5916971,5826220,8556,70865,2021-02-07 9:36,1471,80892,90751,5745328,411,20210207,0:00,2021-04-02 16:18,10,1,435
0,NORMAL SERVICE.,1.389329591,5893350,5795673,8552,70505,2021-02-06 9:32,1464,80521,97677,5715152,410,20210206,0:00,2021-04-02 16:18,10,1,435
0,NORMAL SERVICE.,1.396026773,5847175,5739718,8552,70117,2021-02-05 9:33,1459,80128,107457,5659590,409,20210205,0:00,2021-04-02 16:18,10,1,435
0,NORMAL SERVICE.,1.40355928,5803091,5682553,8606,69704,2021-02-04 9:37,1448,79758,120538,5602795,408,20210204,0:00,2021-04-02 16:19,10,1,435
0,NORMAL SERVICE.,1.411693881,5756710,5617861,8567,69299,2021-02-03 9:31,1441,79307,138849,5538554,407,20210203,0:00,2021-04-02 16:19,10,1,435
0,NORMAL SERVICE.,1.418714361,5711409,5557144,8630,68775,2021-02-02 9:36,1435,78840,154265,5478304,405,20210202,0:00,2021-04-02 16:19,10,1,435
0,NORMAL SERVICE.,1.424139328,5661838,5512382,8770,68309,2021-02-01 10:15,1425,78504,149456,5433878,404,20210201,0:00,2021-04-02 16:20,10,1,435
0,NORMAL SERVICE.,1.424061928,5640814,5491264,8901,67878,2021-01-31 9:32,1420,78199,149550,5413065,403,20210131,0:00,2021-04-02 16:20,10,1,435
0,NORMAL SERVICE.,1.422936244,5616525,5470730,9310,67121,2021-01-30 9:30,1414,77845,145795,5392885,402,20210130,0:00,2021-04-02 16:21,10,1,435
0,NORMAL SERVICE.,1.42612971,5569258,5426505,9487,66503,2021-01-29 9:37,1399,77389,142753,5349116,401,20210129,0:00,2021-04-02 16:22,10,1,435
0,NORMAL SERVICE.,1.429006946,5522183,5382759,9518,66016,2021-01-28 9:38,1386,76920,139424,5305839,400,20210128,0:00,2021-04-02 16:22,10,1,435
0,NORMAL SERVICE.,1.433608451,5469241,5330814,9567,65478,2021-01-27 9:45,1378,76423,138427,5254391,399,20210127,0:00,2021-04-02 16:23,10,1,435
0,NORMAL SERVICE.,1.435693012,5422762,5284138,9700,64793,2021-01-26 9:41,1371,75864,138624,5208274,398,20210126,0:00,2021-04-02 16:24,10,1,435
0,NORMAL SERVICE.,1.440705015,5376080,5241531,11199,62956,2021-01-25 9:38,1360,75515,134549,5166016,397,20210125,0:00,2021-04-02 16:26,10,1,435
0,NORMAL SERVICE.,1.438667775,5354343,5218578,11199,62530,2021-01-24 9:31,1349,75078,135765,5143500,396,20210124,0:00,2021-04-02 16:26,10,1,435
0,NORMAL SERVICE.,1.438185336,5329701,5193072,11305,62044,2021-01-23 9:40,1337,74686,136629,5118386,395,20210123,0:00,2021-04-02 16:27,10,1,435
0,NORMAL SERVICE.,1.442100878,5282217,5149085,11512,61415,2021-01-22 9:36,1328,74255,133132,5074830,394,20210122,0:00,2021-04-02 16:27,10,1,435
0,NORMAL SERVICE.,1.450183056,5237599,5096529,11747,60846,2021-01-21 9:39,1316,73909,141070,5022620,393,20210121,0:00,2021-04-02 16:28,10,1,435
0,NORMAL SERVICE.,1.457361341,5192120,5043979,12029,60180,2021-01-20 9:38,1300,73509,148141,4970470,392,20210120,0:00,2021-04-02 16:29,10,1,435
0,NORMAL SERVICE.,1.466213903,5140316,4985971,12354,59468,2021-01-19 9:39,1283,73105,154345,4912866,391,20210119,0:00,2021-04-02 16:31,10,1,435
0,NORMAL SERVICE.,1.475277303,5087210,4929175,12732,58723,2021-01-18 9:38,1264,72719,158035,4856456,390,20210118,0:00,2021-04-02 16:31,10,1,435
0,NORMAL SERVICE.,1.481179272,5061560,4902175,12838,58523,2021-01-17 9:35,1249,72610,159385,4829565,388,20210117,0:00,2021-01-17 9:35,10,1,435
0,NORMAL SERVICE.,1.472738044,5032270,4876631,13030,57554,2021-01-16 9:49,1236,71820,155639,4804811,387,20210116,0:00,2021-01-16 9:49,10,1,435
0,NORMAL SERVICE.,1.479313488,4978074,4815751,13761,56536,2021-01-15 9:39,1217,71240,162323,4744511,386,20210115,0:00,2021-01-15 9:39,10,1,435
0,NORMAL SERVICE.,1.487251812,4925359,4755617,14383,55772,2021-01-14 9:35,1195,70728,169742,4684889,385,20210114,0:00,2021-01-14 9:35,10,1,435
0,NORMAL SERVICE.,1.497079156,4872312,4689398,14916,54636,2021-01-13 9:37,1185,70204,182914,4619194,384,20210113,0:00,2021-01-13 9:37,10,1,435
0,NORMAL SERVICE.,1.505192536,4814085,4627315,15422,53569,2021-01-12 9:36,1165,69650,186770,4557665,383,20210112,0:00,2021-01-12 9:36,10,1,435
0,NORMAL SERVICE.,1.515019327,4751685,4561922,17129,52552,2021-01-11 9:40,1140,69114,189763,4492808,382,20210111,0:00,2021-01-11 9:40,10,1,435
0,NORMAL SERVICE.,1.5150676,4723463,4532009,17575,50409,2021-01-10 9:25,1125,68663,191454,4463346,381,20210110,0:00,2021-01-10 9:25,10,1,435
0,NORMAL SERVICE.,1.509849805,4689616,4503693,17908,49324,2021-01-09 9:41,1100,67999,185923,4435694,380,20210109,0:00,2021-01-09 9:41,10,1,435
0,NORMAL SERVICE.,1.517225161,4630004,4439552,17989,48369,2021-01-08 9:37,1081,67358,190452,4372194,379,20210108,0:00,2021-01-08 9:37,10,1,435
0,NORMAL SERVICE.,1.523145257,4569808,4378046,17794,47649,2021-01-07 9:38,1046,66684,191762,4311362,378,20210107,0:00,2021-01-07 9:38,10,1,435
0,NORMAL SERVICE.,1.526067617,4504866,4312784,17799,46995,2021-01-06 9:35,1027,65816,192082,4246968,377,20210106,0:00,2021-01-06 9:35,10,1,435
0,NORMAL SERVICE.,1.530475369,4439360,4245609,18043,46172,2021-01-05 9:35,1007,64978,193751,4180631,376,20210105,0:00,2021-01-05 9:35,10,1,435
0,NORMAL SERVICE.,1.535258092,4376608,4185876,17775,45240,2021-01-04 9:33,981,64264,190732,4121612,375,20210104,0:00,2021-01-04 9:33,10,1,435
0,NORMAL SERVICE.,1.522350221,4340838,4154366,18067,44507,2021-01-03 9:31,962,63244,186472,4091122,374,20210103,0:00,2021-01-03 9:31,10,1,435
0,NORMAL SERVICE.,1.517847139,4302793,4123406,17897,43578,2021-01-02 9:34,942,62587,179387,4060819,373,20210102,0:00,2021-01-02 9:34,10,1,435
0,NORMAL SERVICE.,1.509313997,4269316,4092389,17569,42953,2021-01-01 9:36,917,61767,176927,4030622,372,20210101,0:00,2021-01-01 9:36,10,1,435
0,NORMAL SERVICE.,1.502124005,4213879,4043541,17458,42270,2020-12-31 9:35,900,60739,170338,3982802,371,20201231,0:00,2020-12-31 9:35,10,1,435
0,NORMAL SERVICE.,1.498890352,4159521,3987750,17160,41435,2020-12-30 9:35,879,59772,171771,3927978,370,20201230,0:00,2020-12-30 9:35,10,1,435
0,NORMAL SERVICE.,1.495257709,4098178,3927216,17591,40703,2020-12-29 9:37,859,58722,170962,3868494,369,20201229,0:00,2020-12-29 9:37,10,1,435
0,NORMAL SERVICE.,1.490993241,4038306,3868428,17023,39268,2020-12-28 9:40,819,57678,169878,3810750,368,20201228,0:00,2020-12-28 9:40,10,1,435
0,NORMAL SERVICE.,1.481233567,4006411,3839435,16576,39040,2020-12-27 9:32,808,56871,166976,3782564,367,20201227,0:00,2020-12-27 9:32,10,1,435
0,NORMAL SERVICE.,1.466293429,3969414,3812402,15948,38532,2020-12-26 9:35,793,55901,157012,3756501,366,20201226,0:00,2020-12-26 9:35,10,1,435
0,NORMAL SERVICE.,1.447932052,3939356,3782567,15348,38048,2020-12-25 9:19,773,54769,156789,3727798,365,20201225,0:00,2020-12-25 9:19,10,1,435
0,NORMAL SERVICE.,1.434450446,3882206,3731673,15079,37425,2020-12-24 9:37,756,53529,150533,3678144,364,20201224,0:00,2020-12-24 9:37,10,1,435
0,NORMAL SERVICE.,1.430369268,3826566,3673457,14804,36726,2020-12-23 9:35,739,52544,153109,3620913,363,20201223,0:00,2020-12-23 9:35,10,1,435
0,NORMAL SERVICE.,1.420872135,3772426,3621297,14733,35928,2020-12-22 9:35,722,51454,151129,3569843,362,20201222,0:00,2020-12-22 9:35,10,1,435
0,NORMAL SERVICE.,1.41799996,3713857,3567419,14265,35155,2020-12-21 9:35,698,50586,146438,3516833,361,20201221,0:00,2020-12-21 9:35,10,1,435
0,NORMAL SERVICE.,1.401421994,3683090,3543615,13570,34722,2020-12-20 9:32,674,49661,139475,3493954,360,20201220,0:00,2020-12-20 9:32,10,1,435
0,NORMAL SERVICE.,1.379627546,3646241,3520008,12890,34334,2020-12-19 10:32,659,48563,126233,3471445,359,20201219,0:00,2020-12-19 10:32,10,1,435
0,NORMAL SERVICE.,1.365753242,3589797,3479179,12209,33982,2020-12-19 9:39,645,47517,110618,3431662,358,20201218,0:00,2020-12-19 9:39,10,1,435
0,NORMAL SERVICE.,1.350542013,3538840,3439582,11880,33610,2020-12-17 9:34,634,46453,99258,3393129,356,20201217,0:00,2020-12-17 9:34,10,1,435
0,NORMAL SERVICE.,1.338810872,3488766,3393982,11205,32947,2020-12-16 9:37,612,45439,94784,3348543,355,20201216,0:00,2020-12-16 9:37,10,1,435
0,NORMAL SERVICE.,1.325189747,3441220,3347747,10795,32559,2020-12-15 9:34,600,44364,93473,3303383,354,20201215,0:00,2020-12-15 9:34,10,1,435
0,NORMAL SERVICE.,1.314592937,3397039,3307792,10372,32102,2020-12-14 9:38,587,43484,89247,3264308,353,20201214,0:00,2020-12-14 9:38,10,1,435
0,NORMAL SERVICE.,1.302068586,3374593,3284466,9665,31814,2020-12-13 9:48,580,42766,90127,3241700,352,20201213,0:00,2020-12-13 9:48,10,1,435
0,NORMAL SERVICE.,1.279020521,3349864,3263122,9057,31493,2020-12-12 9:19,578,41736,86742,3221386,351,20201212,0:00,2020-12-12 9:19,10,1,435
0,NORMAL SERVICE.,1.26134791,3311213,3233525,8896,31157,2020-12-11 9:33,572,40786,77688,3192739,350,20201211,0:00,2020-12-11 9:33,10,1,435
0,NORMAL SERVICE.,1.251005403,3277946,3205182,8544,30637,2020-12-10 9:27,564,40097,72764,3165085,349,20201210,0:00,2020-12-10 9:27,10,1,435
0,NORMAL SERVICE.,1.230014955,3221317,3150043,8684,29650,2020-12-09 11:28,552,38746,71274,3111297,348,20201208,0:00,2020-12-09 11:28,10,1,435
0,NORMAL SERVICE.,1.240253343,3253221,3178141,8304,30177,2020-12-09 9:44,556,39417,75080,3138724,347,20201209,0:00,2020-12-09 9:44,10,1,435
0,NORMAL SERVICE.,1.214569872,3209369,3141359,7866,29301,2020-12-07 9:30,549,38154,68010,3103205,345,20201207,0:00,2020-12-07 9:30,10,1,435
0,NORMAL SERVICE.,1.200424413,3194860,3127144,7451,29128,2020-12-06 9:48,545,37539,67716,3089605,344,20201206,0:00,2020-12-06 9:48,10,1,435
0,NORMAL SERVICE.,1.185143513,3180489,3114222,7184,28917,2020-12-05 10:15,540,36908,66267,3077314,343,20201205,0:00,2020-12-05 10:15,10,1,435
0,NORMAL SERVICE.,1.17447126,3157409,3093392,6822,28611,2020-12-04 9:44,536,36331,64017,3057061,342,20201204,0:00,2020-12-04 9:44,10,1,435
0,NORMAL SERVICE.,1.164444189,3131886,3066098,6572,28352,2020-12-03 9:49,529,35703,65788,3030395,341,20201203,0:00,2020-12-03 9:49,10,1,435
0,NORMAL SERVICE.,1.155987081,3106970,3041816,6241,28065,2020-12-02 9:35,526,35163,65154,3006653,340,20201202,0:00,2020-12-02 9:35,10,1,435
0,NORMAL SERVICE.,1.147757365,3083997,3019105,6050,27885,2020-12-01 9:36,526,34652,64892,2984453,339,20201201,0:00,2020-12-01 9:36,10,1,435
0,NORMAL SERVICE.,1.140867307,3061172,2997807,5698,27625,2020-11-30 14:29,526,34201,63365,2963606,338,20201130,0:00,2020-11-30 14:29,10,1,435
0,NORMAL SERVICE.,1.131437116,3046910,2984081,5504,27542,2020-11-29 9:33,523,33763,62829,2950318,337,20201129,0:00,2020-11-29 9:33,10,1,435
0,NORMAL SERVICE.,1.12252414,3032004,2973210,5252,27349,2020-11-28 9:31,522,33375,58794,2939835,336,20201128,0:00,2020-11-28 9:31,10,1,435
0,NORMAL SERVICE.,1.113167453,3009562,2952925,4851,27103,2020-11-27 9:39,516,32871,56637,2920054,335,20201127,0:00,2020-11-27 9:39,10,1,435
0,NORMAL SERVICE.,1.101925744,2988045,2932684,4397,26950,2020-11-26 9:44,515,32316,55361,2900368,334,20201126,0:00,2020-11-26 9:44,10,1,435
0,NORMAL SERVICE.,1.090337381,2966405,2910567,4121,26825,2020-11-25 9:32,513,31735,55838,2878832,333,20201125,0:00,2020-11-25 9:32,10,1,435
0,NORMAL SERVICE.,1.085393422,2946399,2888630,3956,26722,2020-11-24 9:33,510,31353,57769,2857277,332,20201124,0:00,2020-11-24 9:33,10,1,435
0,NORMAL SERVICE.,1.081907261,2922135,2865680,3762,26539,2020-11-23 9:33,509,31004,56455,2834676,331,20201123,0:00,2020-11-23 9:33,10,1,435
0,NORMAL SERVICE.,1.076514758,2908890,2854861,3535,26466,2020-11-22 9:35,505,30733,54029,2824128,330,20201122,0:00,2020-11-22 9:35,10,1,435
0,NORMAL SERVICE.,1.068496145,2896746,2845401,3253,26365,2020-11-21 9:35,503,30403,51345,2814998,329,20201121,0:00,2020-11-21 9:35,10,1,435
0,NORMAL SERVICE.,1.062435848,2873443,2825300,3058,26263,2020-11-20 9:35,501,30017,48143,2795283,328,20201120,0:00,2020-11-20 9:35,10,1,435
0,NORMAL SERVICE.,1.055934549,2853843,2808318,2842,26098,2020-11-19 9:32,498,29654,45525,2778664,327,20201119,0:00,2020-11-19 9:32,10,1,435
0,NORMAL SERVICE.,1.04994351,2834362,2791674,2644,25973,2020-11-18 9:34,496,29311,42688,2762363,326,20201118,0:00,2020-11-18 9:34,10,1,435
0,NORMAL SERVICE.,1.045141325,2815755,2774553,2515,25860,2020-11-17 9:38,494,28998,41202,2745555,325,20201117,0:00,2020-11-17 9:38,10,1,435
0,NORMAL SERVICE.,1.042554549,2797690,2759376,2362,25759,2020-11-16 9:34,494,28768,38314,2730608,324,20201116,0:00,2020-11-16 9:34,10,1,435
0,NORMAL SERVICE.,1.037847664,2786878,2750500,2210,25691,2020-11-15 9:40,493,28546,36378,2721954,323,20201115,0:00,2020-11-15 9:40,10,1,435
0,NORMAL SERVICE.,1.033254248,2777289,2742597,2108,25636,2020-11-14 9:31,492,28338,34692,2714259,322,20201114,0:00,2020-11-14 9:31,10,1,435
0,NORMAL SERVICE.,1.030025351,2761411,2731292,2051,25537,2020-11-13 9:35,488,28133,30119,2703159,321,20201113,0:00,2020-11-13 9:35,10,1,435
0,NORMAL SERVICE.,1.027095139,2749772,2720488,2046,25404,2020-11-12 9:39,487,27942,29284,2692546,320,20201112,0:00,2020-11-12 9:39,10,1,435
0,NORMAL SERVICE.,1.026609342,2736534,2707846,2008,25266,2020-11-11 9:35,487,27799,28688,2680047,319,20201111,0:00,2020-11-11 9:35,10,1,435
0,NORMAL SERVICE.,1.025664802,2723960,2696105,2044,25160,2020-11-10 9:37,485,27653,27855,2668452,318,20201110,0:00,2020-11-10 9:37,10,1,435
0,NORMAL SERVICE.,1.026795513,2709199,2683397,1981,25029,2020-11-09 9:36,480,27553,25802,2655844,317,20201109,0:00,2020-11-09 9:36,10,1,435
0,NORMAL SERVICE.,1.024453615,2702880,2677232,1897,24968,2020-11-08 9:34,478,27427,25648,2649805,316,20201108,0:00,2020-11-08 9:34,10,1,435
0,NORMAL SERVICE.,1.021477841,2697249,2671032,1898,24910,2020-11-07 9:40,477,27284,26217,2643748,315,20201107,0:00,2020-11-07 9:40,10,1,435
0,NORMAL SERVICE.,1.02210521,2686314,2660685,1840,24821,2020-11-06 9:24,476,27195,25629,2633490,314,20201106,0:00,2020-11-06 9:24,10,1,435
0,NORMAL SERVICE.,1.021277303,2673706,2648644,1834,24735,2020-11-05 9:51,475,27050,25062,2621594,313,20201105,0:00,2020-11-05 9:51,10,1,435
0,NORMAL SERVICE.,1.020619749,2662260,2638005,1825,24616,2020-11-04 9:37,474,26924,24255,2611081,312,20201104,0:00,2020-11-04 9:37,10,1,435
0,NORMAL SERVICE.,1.021591101,2649859,2624044,1869,24510,2020-11-03 9:30,472,26807,25815,2597237,311,20201103,0:00,2020-11-03 9:30,10,1,435
0,NORMAL SERVICE.,1.023772886,2636650,2611126,1812,24395,2020-11-02 9:35,468,26732,25524,2584394,310,20201102,0:00,2020-11-02 9:35,10,1,435
0,NORMAL SERVICE.,1.02214605,2630630,2605792,1736,24357,2020-11-01 9:41,466,26635,24838,2579157,309,20201101,0:00,2020-11-01 9:41,10,1,435
0,NORMAL SERVICE.,1.020119177,2624492,2598814,1694,24311,2020-10-31 9:35,464,26511,25678,2572303,308,20201031,0:00,2020-10-31 9:35,10,1,435
0,NORMAL SERVICE.,1.020318981,2612231,2585858,1641,24227,2020-10-30 9:31,463,26384,26373,2559474,307,20201030,0:00,2020-10-30 9:31,10,1,435
0,NORMAL SERVICE.,1.021490534,2597978,2571830,1612,24168,2020-10-29 9:37,462,26271,26148,2545559,306,20201029,0:00,2020-10-29 9:37,10,1,435
0,NORMAL SERVICE.,1.021305784,2582960,2560056,1602,24073,2020-10-28 9:35,461,26146,22904,2533910,305,20201028,0:00,2020-10-28 9:35,10,1,435
0,NORMAL SERVICE.,1.023467883,2567587,2544584,1593,23981,2020-10-27 9:38,460,26043,23003,2518541,304,20201027,0:00,2020-10-27 9:38,10,1,435
0,NORMAL SERVICE.,1.025281049,2552264,2531501,1510,23905,2020-10-26 9:38,457,25955,20763,2505546,303,20201026,0:00,2020-10-26 9:38,10,1,435
0,NORMAL SERVICE.,1.023425171,2546146,2524464,1484,23869,2020-10-25 9:35,457,25836,21682,2498628,302,20201025,0:00,2020-10-25 9:35,10,1,435
0,NORMAL SERVICE.,1.023308405,2540679,2518791,1526,23834,2020-10-24 10:28,457,25775,21888,2493016,301,20201024,0:00,2020-10-24 10:28,10,1,435
0,NORMAL SERVICE.,1.024563121,2528621,2508191,1443,23717,2020-10-23 9:37,455,25698,20430,2482493,300,20201023,0:00,2020-10-23 9:37,10,1,435
0,NORMAL SERVICE.,1.02355749,2515325,2495512,1388,23647,2020-10-22 9:41,453,25543,19813,2469969,299,20201022,0:00,2020-10-22 9:41,10,1,435
0,NORMAL SERVICE.,1.0234316,2503489,2483996,1420,23584,2020-10-21 9:34,450,25422,19493,2458574,298,20201021,0:00,2020-10-21 9:34,10,1,435
0,NORMAL SERVICE.,1.024825926,2491311,2471932,1463,23466,2020-10-20 9:32,447,25333,19379,2446599,297,20201020,0:00,2020-10-20 9:32,10,1,435
0,NORMAL SERVICE.,1.026411361,2479226,2462463,1443,23368,2020-10-19 9:42,444,25275,16763,2437188,296,20201019,0:00,2020-10-19 9:42,10,1,435
0,NORMAL SERVICE.,1.025705526,2474529,2456748,1407,23312,2020-10-18 9:33,444,25199,17781,2431549,295,20201018,0:00,2020-10-18 9:33,10,1,435
0,NORMAL SERVICE.,1.02431086,2468527,2451209,1414,23258,2020-10-17 9:49,443,25108,17318,2426101,294,20201017,0:00,2020-10-17 9:49,10,1,435
0,NORMAL SERVICE.,1.025154469,2459426,2442071,1467,23180,2020-10-16 9:34,441,25035,17355,2417036,293,20201016,0:00,2020-10-16 9:34,10,1,435
0,NORMAL SERVICE.,1.027265623,2450739,2432477,1410,23082,2020-10-15 9:39,439,24988,18262,2407489,292,20201015,0:00,2020-10-15 9:39,10,1,435
0,NORMAL SERVICE.,1.02672379,2441443,2423047,1508,23030,2020-10-14 9:35,438,24878,18396,2398169,291,20201014,0:00,2020-10-14 9:35,10,1,435
0,NORMAL SERVICE.,1.02983127,2428771,2408647,1542,22863,2020-10-13 9:40,434,24805,20124,2383842,290,20201013,0:00,2020-10-13 9:40,10,1,435
0,NORMAL SERVICE.,1.030830181,2415610,2396418,1481,22728,2020-10-12 9:41,433,24703,19192,2371715,289,20201012,0:00,2020-10-12 9:41,10,1,435
0,NORMAL SERVICE.,1.028989871,2410483,2391180,1494,22692,2020-10-11 9:32,432,24605,19303,2366575,288,20201011,0:00,2020-10-11 9:32,10,1,435
0,NORMAL SERVICE.,1.028921466,2404684,2385702,1479,22623,2020-10-10 9:39,430,24547,18982,2361155,287,20201010,0:00,2020-10-10 9:39,10,1,435
0,NORMAL SERVICE.,1.028562735,2400233,2379534,1532,22568,2020-10-09 9:37,428,24475,20699,2355059,286,20201009,0:00,2020-10-09 9:37,10,1,435
0,NORMAL SERVICE.,1.031350592,2388844,2367866,1594,22462,2020-10-08 10:01,427,24421,20978,2343445,285,20201008,0:00,2020-10-08 10:01,10,1,435
0,NORMAL SERVICE.,1.033644816,2378073,2355935,1734,22333,2020-10-07 9:42,425,24352,22138,2331583,284,20201007,0:00,2020-10-07 9:42,10,1,435
0,NORMAL SERVICE.,1.034619942,2365433,2342696,1856,22082,2020-10-06 9:39,422,24238,22737,2318458,283,20201006,0:00,2020-10-06 9:39,10,1,435
0,NORMAL SERVICE.,1.037069338,2352378,2329931,1825,21885,2020-10-05 9:32,422,24163,22447,2305768,282,20201005,0:00,2020-10-05 9:32,10,1,435
0,NORMAL SERVICE.,1.03647274,2346345,2324229,1820,21844,2020-10-04 9:35,421,24090,22116,2300139,281,20201004,0:00,2020-10-04 9:35,10,1,435
0,NORMAL SERVICE.,1.036241273,2339859,2318572,1803,21786,2020-10-03 9:49,420,24026,21287,2294546,280,20201003,0:00,2020-10-03 9:49,10,1,435
0,NORMAL SERVICE.,1.035145057,2333777,2313782,1808,21732,2020-10-02 9:51,416,23951,19995,2289831,279,20201002,0:00,2020-10-02 9:51,10,1,435
0,NORMAL SERVICE.,1.034826629,2328435,2308406,1808,21665,2020-10-01 9:38,415,23888,20029,2284518,278,20201001,0:00,2020-10-01 9:38,10,1,435
0,NORMAL SERVICE.,1.034180376,2322999,2302403,1822,21590,2020-09-30 9:32,413,23811,20596,2278592,277,20200930,0:00,2020-09-30 9:32,10,1,435
0,NORMAL SERVICE.,1.033498649,2313044,2292988,1963,21469,2020-09-29 9:40,407,23698,20056,2269290,276,20200929,0:00,2020-09-29 9:40,10,1,435
0,NORMAL SERVICE.,1.036484609,2301303,2282716,1962,21291,2020-09-28 10:25,406,23660,18587,2259056,275,20200928,0:00,2020-09-28 10:25,10,1,435
0,NORMAL SERVICE.,1.036599742,2296517,2277639,1951,21247,2020-09-27 10:12,401,23610,18878,2254029,274,20200927,0:00,2020-09-27 10:12,10,1,435
0,NORMAL SERVICE.,1.035065456,2290345,2271837,2082,21165,2020-09-26 10:01,399,23515,18508,2248322,273,20200926,0:00,2020-09-26 10:01,10,1,435
0,NORMAL SERVICE.,1.037465813,2280276,2260701,2116,20977,2020-09-25 9:56,395,23454,19575,2237247,272,20200925,0:00,2020-09-25 9:56,10,1,435
0,NORMAL SERVICE.,1.038156014,2268999,2248217,2178,20831,2020-09-24 10:06,393,23340,20782,2224877,271,20200924,0:00,2020-09-24 10:06,10,1,435
0,NORMAL SERVICE.,1.038065223,2256899,2236372,2277,20649,2020-09-23 10:11,388,23215,20527,2213157,270,20200923,0:00,2020-09-23 10:11,10,1,435
0,NORMAL SERVICE.,1.039880462,2245112,2221890,2412,20440,2020-09-22 10:08,388,23105,23222,2198785,269,20200922,0:00,2020-09-22 10:08,10,1,435
0,NORMAL SERVICE.,1.043161934,2231589,2209053,2434,20247,2020-09-21 10:01,385,23044,22536,2186009,268,20200921,0:00,2020-09-21 10:01,10,1,435
0,NORMAL SERVICE.,1.043121974,2226701,2202427,2545,20157,2020-09-20 9:52,383,22974,24274,2179453,267,20200920,0:00,2020-09-20 9:52,10,1,435
0,NORMAL SERVICE.,1.043173778,2219162,2194457,2635,19969,2020-09-19 10:09,378,22892,24705,2171565,266,20200919,0:00,2020-09-19 10:09,10,1,435
0,NORMAL SERVICE.,1.044584913,2206365,2180962,2742,19770,2020-09-18 9:58,377,22782,25403,2158180,265,20200918,0:00,2020-09-18 9:58,10,1,435
0,NORMAL SERVICE.,1.045797975,2191892,2166384,2827,19542,2020-09-17 10:09,372,22656,25508,2143728,264,20200917,0:00,2020-09-17 10:09,10,1,435
0,NORMAL SERVICE.,1.045197609,2178832,2152990,3146,19309,2020-09-16 9:37,367,22503,25842,2130487,263,20200916,0:00,2020-09-16 9:37,10,1,435
0,NORMAL SERVICE.,1.047599084,2164578,2137268,3433,18877,2020-09-15 9:48,367,22390,27310,2114878,262,20200915,0:00,2020-09-15 9:48,10,1,435
0,NORMAL SERVICE.,1.049386727,2151002,2123526,3592,18488,2020-09-14 9:54,363,22284,27476,2101242,261,20200914,0:00,2020-09-14 9:54,10,1,435
0,NORMAL SERVICE.,1.048183346,2143270,2115565,3671,18225,2020-09-13 11:05,358,22175,27705,2093390,260,20200913,0:00,2020-09-13 11:05,10,1,435
0,NORMAL SERVICE.,1.046388101,2135457,2107631,3953,18028,2020-09-12 10:03,355,22054,27826,2085577,259,20200912,0:00,2020-09-12 10:03,10,1,435
0,NORMAL SERVICE.,1.048814521,2119211,2089788,4037,17615,2020-09-11 9:34,350,21918,29423,2067870,258,20200911,0:00,2020-09-11 9:34,10,1,435
0,NORMAL SERVICE.,1.052079941,2099591,2066573,4221,17359,2020-09-10 9:43,346,21742,33018,2044831,257,20200910,0:00,2020-09-10 9:43,10,1,435
0,NORMAL SERVICE.,1.0552373,2082234,2045701,4455,17022,2020-09-09 10:04,344,21587,36533,2024114,256,20200909,0:00,2020-09-09 10:04,10,1,435
0,NORMAL SERVICE.,1.059520208,2066078,2022708,4663,16635,2020-09-08 9:34,341,21431,43370,2001277,255,20200908,0:00,2020-09-08 9:34,10,1,435
0,NORMAL SERVICE.,1.062525072,2051297,2004188,4697,16296,2020-09-07 9:34,336,21295,47109,1982893,254,20200907,0:00,2020-09-07 9:34,10,1,435
0,NORMAL SERVICE.,1.060754971,2045935,1996314,4668,16145,2020-09-06 9:48,334,21176,49621,1975138,253,20200906,0:00,2020-09-06 9:48,10,1,435
0,NORMAL SERVICE.,1.058404972,2037045,1984968,4727,16008,2020-09-05 9:34,333,21009,52077,1963959,252,20200905,0:00,2020-09-05 9:34,10,1,435
0,NORMAL SERVICE.,1.059726233,2018906,1966640,4785,15783,2020-09-04 9:46,331,20841,52266,1945799,251,20200904,0:00,2020-09-04 9:46,10,1,435
0,NORMAL SERVICE.,1.061321482,2000552,1945028,4766,15529,2020-09-03 9:37,329,20643,55524,1924385,250,20200903,0:00,2020-09-03 9:37,10,1,435
0,NORMAL SERVICE.,1.063036151,1980295,1923547,4659,15356,2020-09-02 10:20,326,20448,56748,1903099,249,20200902,0:00,2020-09-02 10:20,10,1,435
0,NORMAL SERVICE.,1.060853045,1959080,1902337,4649,15198,2020-09-01 9:32,324,20181,56743,1882156,248,20200901,0:00,2020-09-01 9:32,10,1,435
0,NORMAL SERVICE.,1.061062989,1937689,1879813,4472,14973,2020-08-31 9:32,324,19946,57876,1859867,247,20200831,0:00,2020-08-31 9:32,10,1,435
0,NORMAL SERVICE.,1.055542725,1924170,1866149,4313,14903,2020-08-30 9:37,323,19698,58021,1846451,246,20200830,0:00,2020-08-30 9:37,10,1,435
0,NORMAL SERVICE.,1.045608675,1909329,1855283,4209,14765,2020-08-29 9:56,321,19399,54046,1835884,245,20200829,0:00,2020-08-29 9:56,10,1,435
0,NORMAL SERVICE.,1.038428835,1887717,1837006,3931,14551,2020-08-28 9:39,316,19076,50711,1817930,244,20200828,0:00,2020-08-28 9:39,10,1,435
0,NORMAL SERVICE.,1.029139418,1869579,1817538,3584,14461,2020-08-27 10:15,313,18705,52041,1798833,243,20200827,0:00,2020-08-27 10:15,10,1,435
0,NORMAL SERVICE.,1.016524082,1849506,1796711,3348,14368,2020-08-26 10:20,312,18264,52795,1778447,242,20200826,0:00,2020-08-26 10:20,10,1,435
0,NORMAL SERVICE.,1.010659119,1825837,1775475,3136,14286,2020-08-25 10:23,310,17944,50362,1757531,241,20200825,0:00,2020-08-25 10:23,10,1,435
0,NORMAL SERVICE.,1.005678004,1804422,1756427,2889,14219,2020-08-24 10:17,309,17664,47995,1738763,240,20200824,0:00,2020-08-24 10:17,10,1,435
0,NORMAL SERVICE.,0.997808011,1791186,1743622,2524,14200,2020-08-23 10:21,309,17398,47564,1726224,239,20200823,0:00,2020-08-23 10:21,10,1,435
0,NORMAL SERVICE.,0.980862169,1775800,1733373,2241,14169,2020-08-22 10:15,309,17002,42427,1716371,238,20200822,0:00,2020-08-22 10:15,10,1,435
0,NORMAL SERVICE.,0.971401067,1754123,1716078,1976,14120,2020-08-21 10:21,309,16670,38045,1699408,237,20200821,0:00,2020-08-21 10:21,10,1,435
0,NORMAL SERVICE.,0.96204722,1734083,1699085,1746,14063,2020-08-20 10:13,307,16346,34998,1682739,236,20200820,0:00,2020-08-20 10:13,10,1,435
0,NORMAL SERVICE.,0.953539164,1715064,1684042,1521,14006,2020-08-19 10:12,306,16058,31022,1667984,235,20200819,0:00,2020-08-19 10:12,10,1,435
0,NORMAL SERVICE.,0.942743341,1697042,1671823,1293,13934,2020-08-18 10:13,306,15761,25219,1656062,234,20200818,0:00,2020-08-18 10:13,10,1,435
0,NORMAL SERVICE.,0.93154873,1688470,1665506,1103,13917,2020-08-18 9:12,305,15515,22964,1649991,233,20200817,0:00,2020-08-18 9:12,10,1,435
0,NORMAL SERVICE.,0.922892283,1681787,1659782,833,13910,2020-08-16 10:33,305,15318,22005,1644464,232,20200816,0:00,2020-08-16 10:33,10,1,435
0,NORMAL SERVICE.,0.909427349,1675296,1653678,705,13901,2020-08-15 9:04,305,15039,21618,1638639,231,20200815,0:00,2020-08-15 9:04,10,1,435
0,NORMAL SERVICE.,0.904160121,1665084,1644952,648,13863,2020-08-14 10:25,305,14873,20132,1630079,230,20200814,0:00,2020-08-14 10:25,10,1,435
0,NORMAL SERVICE.,0.902205119,1654898,1637100,623,13817,2020-08-13 10:26,305,14770,17798,1622330,229,20200813,0:00,2020-08-13 10:26,10,1,435
0,NORMAL SERVICE.,0.903099964,1646652,1629277,626,13786,2020-08-12 10:41,305,14714,17375,1614563,228,20200812,0:00,2020-08-12 10:41,10,1,435
0,NORMAL SERVICE.,0.904740011,1637844,1620355,663,13729,2020-08-11 10:28,305,14660,17489,1605695,227,20200811,0:00,2020-08-11 10:28,10,1,435
0,NORMAL SERVICE.,0.907372448,1628303,1611907,651,13658,2020-08-10 10:37,305,14626,16396,1597281,226,20200810,0:00,2020-08-10 10:37,10,1,435
0,NORMAL SERVICE.,0.907922209,1624650,1607847,629,13642,2020-08-09 10:42,305,14598,16803,1593249,225,20200809,0:00,2020-08-09 10:42,10,1,435
0,NORMAL SERVICE.,0.907623929,1620514,1604409,673,13629,2020-08-08 10:18,304,14562,16105,1589847,224,20200808,0:00,2020-08-08 10:18,10,1,435
0,NORMAL SERVICE.,0.909379024,1613652,1596584,696,13543,2020-08-07 10:11,303,14519,17068,1582065,223,20200807,0:00,2020-08-07 10:11,10,1,435
0,NORMAL SERVICE.,0.912773158,1606487,1588456,748,13501,2020-08-06 10:22,302,14499,18031,1573957,222,20200806,0:00,2020-08-06 10:22,10,1,435
0,NORMAL SERVICE.,0.915112202,1598187,1579697,770,13406,2020-08-05 10:20,302,14456,18490,1565241,221,20200805,0:00,2020-08-05 10:20,10,1,435
0,NORMAL SERVICE.,0.918044933,1589780,1571056,808,13352,2020-08-04 10:49,301,14423,18724,1556633,220,20200804,0:00,2020-08-04 10:49,10,1,435
0,NORMAL SERVICE.,0.920980878,1579757,1562356,806,13280,2020-08-03 10:22,301,14389,17401,1547967,219,20200803,0:00,2020-08-03 10:22,10,1,435
0,NORMAL SERVICE.,0.921796779,1576246,1558478,802,13259,2020-08-02 12:17,301,14366,17768,1544112,218,20200802,0:00,2020-08-02 12:17,10,1,435
0,NORMAL SERVICE.,0.922788552,1571830,1553552,821,13233,2020-08-01 10:20,301,14336,18278,1539216,217,20200801,0:00,2020-08-01 10:20,10,1,435
0,NORMAL SERVICE.,0.925610787,1563796,1545466,837,13183,2020-07-31 10:36,301,14305,18330,1531161,216,20200731,0:00,2020-07-31 10:36,10,1,435
0,NORMAL SERVICE.,0.928247973,1556215,1537197,882,13132,2020-07-30 11:11,300,14269,19018,1522928,215,20200730,0:00,2020-07-30 11:11,10,1,435
0,NORMAL SERVICE.,0.932668665,1547307,1527981,896,13069,2020-07-29 10:44,300,14251,19326,1513730,214,20200729,0:00,2020-07-29 10:44,10,1,435
0,NORMAL SERVICE.,0.93609533,1537704,1517260,971,13007,2020-07-28 10:31,300,14203,20444,1503057,213,20200728,0:00,2020-07-28 10:31,10,1,435
0,NORMAL SERVICE.,0.939859595,1526974,1508204,962,12905,2020-07-27 10:35,299,14175,18770,1494029,212,20200727,0:00,2020-07-27 10:35,10,1,435
0,NORMAL SERVICE.,0.94100466,1522926,1503712,928,12890,2020-07-26 10:28,298,14150,19214,1489562,211,20200726,0:00,2020-07-26 10:28,10,1,435
0,NORMAL SERVICE.,0.940122872,1518634,1498953,864,12866,2020-07-25 10:19,298,14092,19681,1484861,210,20200725,0:00,2020-07-25 10:19,10,1,435
0,NORMAL SERVICE.,0.938334022,1510327,1489768,883,12817,2020-07-24 11:05,298,13979,20559,1475789,209,20200724,0:00,2020-07-24 11:05,10,1,435
0,NORMAL SERVICE.,0.942115779,1500854,1479436,884,12758,2020-07-23 10:38,297,13938,21418,1465498,208,20200723,0:00,2020-07-23 10:38,10,1,435
0,NORMAL SERVICE.,0.943944175,1492071,1470320,877,12698,2020-07-22 10:27,297,13879,21751,1456441,207,20200722,0:00,2020-07-22 10:27,10,1,435
0,NORMAL SERVICE.,0.947257711,1482390,1458526,903,12643,2020-07-21 11:07,296,13816,23864,1444710,206,20200721,0:00,2020-07-21 11:07,10,1,435
0,NORMAL SERVICE.,0.950451069,1470193,1448891,894,12572,2020-07-20 10:55,296,13771,21302,1435120,205,20200720,0:00,2020-07-20 10:55,10,1,435
0,NORMAL SERVICE.,0.952301111,1465299,1443346,898,12556,2020-07-19 10:19,295,13745,21953,1429601,204,20200719,0:00,2020-07-19 10:19,10,1,435
0,NORMAL SERVICE.,0.953954028,1460204,1437281,919,12519,2020-07-18 10:13,294,13711,22923,1423570,203,20200718,0:00,2020-07-18 10:13,10,1,435
0,NORMAL SERVICE.,0.957485326,1451017,1427907,925,12460,2020-07-17 10:40,293,13672,23110,1414235,202,20200717,0:00,2020-07-17 10:40,10,1,435
0,NORMAL SERVICE.,0.959981494,1441348,1417944,914,12396,2020-07-16 10:44,291,13612,23404,1404332,201,20200716,0:00,2020-07-16 10:44,10,1,435
0,NORMAL SERVICE.,0.96241599,1431316,1408019,941,12348,2020-07-15 10:38,289,13551,23297,1394468,200,20200715,0:00,2020-07-15 10:38,10,1,435
0,NORMAL SERVICE.,0.967681639,1420616,1396327,986,12282,2020-07-14 10:42,289,13512,24289,1382815,199,20200714,0:00,2020-07-14 10:42,10,1,435
0,NORMAL SERVICE.,0.972183254,1408312,1386467,950,12204,2020-07-13 10:20,289,13479,21845,1372988,198,20200713,0:00,2020-07-13 10:20,10,1,435
0,NORMAL SERVICE.,0.972025206,1402144,1380314,941,12178,2020-07-12 10:21,289,13417,21830,1366897,197,20200712,0:00,2020-07-12 10:21,10,1,435
0,NORMAL SERVICE.,0.97329604,1396941,1373991,985,12144,2020-07-11 10:24,288,13373,22950,1360618,196,20200711,0:00,2020-07-11 10:24,10,1,435
0,NORMAL SERVICE.,0.979753379,1384890,1361363,987,12065,2020-07-10 10:16,288,13338,23527,1348025,195,20200710,0:00,2020-07-10 10:16,10,1,435
0,NORMAL SERVICE.,0.986230755,1371771,1347859,988,12019,2020-07-09 10:50,287,13293,23912,1334566,194,20200709,0:00,2020-07-09 10:50,10,1,435
0,NORMAL SERVICE.,0.991448819,1359734,1335722,982,11970,2020-07-08 10:19,285,13243,24012,1322479,193,20200708,0:00,2020-07-08 10:19,10,1,435
0,NORMAL SERVICE.,0.996658649,1346194,1322519,1005,11914,2020-07-07 10:15,285,13181,23675,1309338,192,20200707,0:00,2020-07-07 10:15,10,1,435
0,NORMAL SERVICE.,1.002438756,1331796,1310504,974,11848,2020-07-06 10:42,284,13137,21292,1297367,191,20200706,0:00,2020-07-06 10:42,10,1,435
0,NORMAL SERVICE.,1.003445246,1326055,1304406,934,11832,2020-07-05 10:25,283,13089,21649,1291317,190,20200705,0:00,2020-07-05 10:25,10,1,435
0,NORMAL SERVICE.,1.00431699,1319521,1297200,924,11811,2020-07-04 10:13,283,13028,22321,1284172,189,20200704,0:00,2020-07-04 10:13,10,1,435
0,NORMAL SERVICE.,1.008007302,1307761,1286201,938,11759,2020-07-03 10:19,282,12965,21560,1273236,188,20200703,0:00,2020-07-03 10:19,10,1,435
0,NORMAL SERVICE.,1.011142629,1295962,1276180,955,11684,2020-07-02 10:27,282,12904,19782,1263276,187,20200702,0:00,2020-07-02 10:27,10,1,435
0,NORMAL SERVICE.,1.015244468,1285231,1265705,980,11613,2020-07-01 10:35,282,12850,19526,1252855,186,20200701,0:00,2020-07-01 10:35,10,1,435
0,NORMAL SERVICE.,1.021504347,1273765,1252956,1046,11537,2020-06-30 11:19,282,12799,20809,1240157,185,20200630,0:00,2020-06-30 11:19,10,1,435
0,NORMAL SERVICE.,1.027584568,1259954,1241455,1069,11429,2020-06-29 10:29,282,12757,18499,1228698,184,20200629,0:00,2020-06-29 10:29,10,1,435
0,NORMAL SERVICE.,1.03148399,1251695,1232690,1054,11364,2020-06-28 10:29,282,12715,19005,1219975,183,20200628,0:00,2020-06-28 10:29,10,1,435
0,NORMAL SERVICE.,1.033814467,1243780,1223914,1148,11317,2020-06-27 10:47,282,12653,19866,1211261,182,20200627,0:00,2020-06-27 10:47,10,1,435
0,NORMAL SERVICE.,1.03849485,1232315,1213487,1307,11172,2020-06-26 10:13,282,12602,18828,1200885,181,20200626,0:00,2020-06-26 10:13,10,1,435
0,NORMAL SERVICE.,1.045541779,1220478,1201578,1324,10974,2020-06-25 10:19,282,12563,18900,1189015,180,20200625,0:00,2020-06-25 10:19,10,1,435
0,NORMAL SERVICE.,1.05482214,1208597,1188352,1295,10930,2020-06-24 10:31,281,12535,20245,1175817,179,20200624,0:00,2020-06-24 10:31,10,1,435
0,NORMAL SERVICE.,1.063614073,1196012,1173734,1277,10908,2020-06-23 10:41,281,12484,22278,1161250,178,20200623,0:00,2020-06-23 10:41,10,1,435
0,NORMAL SERVICE.,1.069785484,1182066,1162663,1273,10881,2020-06-22 11:40,280,12438,19403,1150225,177,20200622,0:00,2020-06-22 11:40,10,1,435
0,NORMAL SERVICE.,1.074116736,1176463,1156392,1237,10868,2020-06-21 10:10,280,12421,20071,1143971,176,20200621,0:00,2020-06-21 10:10,10,1,435
0,NORMAL SERVICE.,1.07644565,1170901,1149431,1191,10856,2020-06-20 10:14,280,12373,21470,1137058,175,20200620,0:00,2020-06-20 10:14,10,1,435
0,NORMAL SERVICE.,1.082442806,1158063,1136873,1177,10835,2020-06-19 10:32,280,12306,21190,1124567,174,20200619,0:00,2020-06-19 10:32,10,1,435
0,NORMAL SERVICE.,1.090482367,1145712,1123998,1145,10800,2020-06-18 10:12,280,12257,21714,1111741,173,20200618,0:00,2020-06-18 10:12,10,1,435
0,NORMAL SERVICE.,1.097599821,1132823,1111334,1117,10774,2020-06-17 10:14,279,12198,21489,1099136,172,20200617,0:00,2020-06-17 10:14,10,1,435
0,NORMAL SERVICE.,1.107885538,1119767,1097135,1114,10760,2020-06-16 10:16,278,12155,22632,1084980,171,20200616,0:00,2020-06-16 10:16,10,1,435
0,NORMAL SERVICE.,1.117219055,1105719,1084926,1089,10730,2020-06-15 10:16,277,12121,20793,1072805,170,20200615,0:00,2020-06-15 10:16,10,1,435
0,NORMAL SERVICE.,1.119955958,1100327,1078971,1082,10718,2020-06-14 10:19,277,12084,21356,1066887,169,20200614,0:00,2020-06-14 10:19,10,1,435
0,NORMAL SERVICE.,1.124748098,1094703,1071351,1056,10691,2020-06-13 10:11,277,12050,23352,1059301,168,20200613,0:00,2020-06-13 10:11,10,1,435
0,NORMAL SERVICE.,1.135217859,1081486,1057242,1016,10669,2020-06-12 10:22,277,12002,24244,1045240,167,20200612,0:00,2020-06-12 10:22,10,1,435
0,NORMAL SERVICE.,1.147117371,1066887,1041393,1014,10654,2020-06-11 10:30,276,11946,25494,1029447,166,20200611,0:00,2020-06-11 10:30,10,1,435
0,NORMAL SERVICE.,1.160226488,1051971,1025748,988,10611,2020-06-10 10:13,276,11901,26223,1013847,165,20200610,0:00,2020-06-10 10:13,10,1,435
0,NORMAL SERVICE.,1.175068441,1035996,1008537,977,10589,2020-06-09 10:08,274,11851,27459,996686,164,20200609,0:00,2020-06-09 10:08,10,1,435
0,NORMAL SERVICE.,1.188623107,1018213,993839,951,10563,2020-06-08 10:14,273,11813,24374,982026,163,20200608,0:00,2020-06-08 10:14,10,1,435
0,NORMAL SERVICE.,1.193971741,1012769,986288,915,10552,2020-06-07 10:20,273,11776,26481,974512,162,20200607,0:00,2020-06-07 10:20,10,1,435
0,NORMAL SERVICE.,1.199057452,1005305,977351,889,10531,2020-06-06 10:49,273,11719,27954,965632,161,20200606,0:00,2020-06-06 10:49,10,1,435
0,NORMAL SERVICE.,1.212645267,990960,962194,857,10506,2020-06-05 10:56,273,11668,28766,950526,160,20200605,0:00,2020-06-05 10:56,10,1,435
0,NORMAL SERVICE.,1.229724457,973858,945659,850,10499,2020-06-04 10:27,273,11629,28199,934030,159,20200604,0:00,2020-06-04 10:27,10,1,435
0,NORMAL SERVICE.,1.247595499,956852,928987,823,10467,2020-06-03 10:25,273,11590,27865,917397,158,20200603,0:00,2020-06-03 10:25,10,1,435
0,NORMAL SERVICE.,1.266948357,939851,910929,810,10446,2020-06-02 10:15,272,11541,28922,899388,157,20200602,0:00,2020-06-02 10:15,10,1,435
0,NORMAL SERVICE.,1.281909837,921391,897333,793,10422,2020-06-01 10:13,271,11503,24058,885830,156,20200601,0:00,2020-06-01 10:13,10,1,435
0,NORMAL SERVICE.,1.292128248,910822,887528,774,10405,2020-05-31 10:22,270,11468,23294,876060,155,20200531,0:00,2020-05-31 10:22,10,1,435
0,NORMAL SERVICE.,1.305151819,902901,876603,770,10398,2020-05-30 10:12,269,11441,26298,865162,154,20200530,0:00,2020-05-30 10:12,10,1,435
0,NORMAL SERVICE.,1.324946576,885120,860563,735,10363,2020-05-29 10:10,269,11402,24557,849161,153,20200529,0:00,2020-05-29 10:10,10,1,435
0,NORMAL SERVICE.,1.340429353,868666,846296,701,10340,2020-05-28 10:11,269,11344,22370,834952,152,20200528,0:00,2020-05-28 10:11,10,1,435
0,NORMAL SERVICE.,1.354267475,852876,831815,681,10295,2020-05-27 10:16,269,11265,21061,820550,151,20200527,0:00,2020-05-27 10:16,10,1,435
0,NORMAL SERVICE.,1.373204588,839475,817431,713,10275,2020-05-26 10:12,269,11225,22044,806206,150,20200526,0:00,2020-05-26 10:12,10,1,435
0,NORMAL SERVICE.,1.388001209,826437,807348,711,10226,2020-05-25 10:27,267,11206,19089,796142,149,20200525,0:00,2020-05-25 10:27,10,1,435
0,NORMAL SERVICE.,1.398826935,820289,799956,705,10213,2020-05-24 10:29,266,11190,20333,788766,148,20200524,0:00,2020-05-24 10:29,10,1,435
0,NORMAL SERVICE.,1.408209109,814420,792851,716,10194,2020-05-23 10:34,266,11165,21569,781686,147,20200523,0:00,2020-05-23 10:34,10,1,435
0,NORMAL SERVICE.,1.42456772,802418,782132,723,10162,2020-05-22 10:15,264,11142,20286,770990,146,20200522,0:00,2020-05-22 10:15,10,1,435
0,NORMAL SERVICE.,1.443300307,788684,770595,781,10135,2020-05-21 10:24,264,11122,18089,759473,145,20200521,0:00,2020-05-21 10:24,10,1,435
0,NORMAL SERVICE.,1.461684397,776433,760082,877,10066,2020-05-20 10:13,263,11110,16351,748972,144,20200520,0:00,2020-05-20 10:13,10,1,435
0,NORMAL SERVICE.,1.479732158,765574,748649,898,9938,2020-05-19 10:22,263,11078,16925,737571,143,20200519,0:00,2020-05-19 10:22,10,1,435
0,NORMAL SERVICE.,1.50111651,753211,737118,900,9904,2020-05-18 10:18,263,11065,16093,726053,142,20200518,0:00,2020-05-18 10:18,10,1,435
0,NORMAL SERVICE.,1.513713145,747653,729993,924,9888,2020-05-17 10:12,262,11050,17660,718943,141,20200517,0:00,2020-05-17 10:12,10,1,435
0,NORMAL SERVICE.,1.528031211,740645,722302,937,9851,2020-05-16 10:19,262,11037,18343,711265,140,20200516,0:00,2020-05-16 10:19,10,1,435
0,NORMAL SERVICE.,1.558698039,726747,706872,969,9821,2020-05-15 10:33,260,11018,19875,695854,139,20200515,0:00,2020-05-15 10:33,10,1,435
0,NORMAL SERVICE.,1.591141377,711484,690762,1008,9762,2020-05-14 10:18,260,10991,20722,679771,138,20200514,0:00,2020-05-14 10:18,10,1,435
0,NORMAL SERVICE.,1.62078005,695920,676341,1008,9695,2020-05-13 10:41,259,10962,19579,665379,137,20200513,0:00,2020-05-13 10:41,10,1,435
0,NORMAL SERVICE.,1.645600096,680890,664560,1021,9670,2020-05-12 10:12,258,10936,16330,653624,136,20200512,0:00,2020-05-12 10:12,10,1,435
0,NORMAL SERVICE.,1.658986876,668492,657570,1008,9632,2020-05-11 10:25,256,10909,10922,646661,135,20200511,0:00,2020-05-11 10:25,10,1,435
0,NORMAL SERVICE.,1.663306606,663886,653758,1016,9610,2020-05-10 10:14,256,10874,10128,642884,134,20200510,0:00,2020-05-10 10:14,10,1,435
0,NORMAL SERVICE.,1.665445238,660030,650877,1082,9568,2020-05-09 10:17,256,10840,9153,640037,133,20200509,0:00,2020-05-09 10:17,10,1,435
0,NORMAL SERVICE.,1.675242571,654863,645996,1135,9484,2020-05-08 10:18,256,10822,8867,635174,132,20200508,0:00,2020-05-08 10:18,10,1,435
0,NORMAL SERVICE.,1.686535332,649388,640959,1218,9419,2020-05-07 10:43,256,10810,8429,630149,131,20200507,0:00,2020-05-07 10:43,10,1,435
0,NORMAL SERVICE.,1.701501844,643095,635086,1267,9333,2020-05-06 10:16,255,10806,8009,624280,130,20200506,0:00,2020-05-06 10:16,10,1,435
0,NORMAL SERVICE.,1.711175063,640237,631379,1332,9283,2020-05-05 10:20,254,10804,8858,620575,129,20200505,0:00,2020-05-05 10:20,10,1,435
0,NORMAL SERVICE.,1.726102486,633921,625745,1360,9217,2020-05-04 10:11,252,10801,8176,614944,128,20200504,0:00,2020-05-04 10:11,10,1,435
0,NORMAL SERVICE.,1.734135623,630973,622385,1407,9183,2020-05-03 10:54,250,10793,8588,611592,127,20200503,0:00,2020-05-03 10:54,10,1,435
0,NORMAL SERVICE.,1.741332911,627562,619066,1454,9123,2020-05-02 10:22,250,10780,8496,608286,126,20200502,0:00,2020-05-02 10:22,10,1,435
0,NORMAL SERVICE.,1.753626397,623069,614384,1459,9072,2020-05-01 10:24,248,10774,8685,603610,125,20200501,0:00,2020-05-01 10:24,10,1,435
0,NORMAL SERVICE.,1.761153838,619881,611247,1593,9059,2020-04-30 10:12,247,10765,8634,600482,124,20200430,0:00,2020-04-30 10:12,10,1,435
0,NORMAL SERVICE.,1.776064962,614197,605890,1654,8922,2020-04-29 10:26,246,10761,8307,595129,123,20200429,0:00,2020-04-29 10:26,10,1,435
0,NORMAL SERVICE.,1.794060179,608514,599311,1731,8854,2020-04-28 10:22,244,10752,9203,588559,122,20200428,0:00,2020-04-28 10:22,10,1,435
0,NORMAL SERVICE.,1.811510464,601660,592765,1769,8764,2020-04-27 10:12,243,10738,8895,582027,121,20200427,0:00,2020-04-27 10:12,10,1,435
0,NORMAL SERVICE.,1.820508208,598285,589286,1843,8717,2020-04-26 10:12,242,10728,8999,578558,120,20200426,0:00,2020-04-26 10:12,10,1,435
0,NORMAL SERVICE.,1.829316166,595161,585902,1967,8635,2020-04-25 10:58,240,10718,9259,575184,119,20200425,0:00,2020-04-25 10:58,10,1,435
0,NORMAL SERVICE.,1.846461581,589520,579920,2051,8501,2020-04-24 10:11,240,10708,9600,569212,116,20200424,0:00,2020-04-24 10:11,10,1,435
0,NORMAL SERVICE.,1.865005786,583971,573832,2179,8411,2020-04-23 10:11,240,10702,10139,563130,115,20200423,0:00,2020-04-23 10:11,10,1,435
0,NORMAL SERVICE.,1.88994023,577959,565838,2233,8277,2020-04-22 10:20,238,10694,12121,555144,114,20200422,0:00,2020-04-22 10:20,10,1,435
0,NORMAL SERVICE.,1.913511364,571014,558293,2324,8213,2020-04-21 10:11,237,10683,12721,547610,113,20200421,0:00,2020-04-21 10:11,10,1,435
0,NORMAL SERVICE.,1.937015247,563035,551054,2385,8114,2020-04-20 10:26,236,10674,11981,540380,112,20200420,0:00,2020-04-20 10:26,10,1,435
0,NORMAL SERVICE.,1.949472083,559109,546866,2484,8042,2020-04-19 10:27,234,10661,12243,536205,111,20200419,0:00,2020-04-19 10:27,10,1,435
0,NORMAL SERVICE.,1.968098078,554834,541284,2576,7937,2020-04-18 10:44,232,10653,13550,530631,110,20200418,0:00,2020-04-18 10:44,10,1,435
0,NORMAL SERVICE.,1.998019828,546463,532277,2627,7829,2020-04-17 10:32,230,10635,14186,521642,109,20200417,0:00,2020-04-17 10:32,10,1,435
0,NORMAL SERVICE.,2.023423901,538775,524507,2750,7757,2020-04-16 10:55,229,10613,14268,513894,108,20200416,0:00,2020-04-16 10:55,10,1,435
0,NORMAL SERVICE.,2.038589022,534552,519526,2808,7616,2020-04-15 11:34,225,10591,15026,508935,107,20200415,0:00,2020-04-15 11:34,10,1,435
0,NORMAL SERVICE.,2.060114628,527438,512787,2873,7534,2020-04-14 10:23,222,10564,14651,502223,106,20200414,0:00,2020-04-14 10:23,10,1,435
0,NORMAL SERVICE.,2.08508129,518743,505352,2930,7447,2020-04-13 10:14,217,10537,13391,494815,105,20200413,0:00,2020-04-13 10:14,10,1,435
0,NORMAL SERVICE.,2.098903227,514621,500833,3026,7368,2020-04-12 10:20,214,10512,13788,490321,104,20200412,0:00,2020-04-12 10:20,10,1,435
0,NORMAL SERVICE.,2.111162368,510479,496409,3125,7243,2020-04-11 10:24,211,10480,14070,485929,103,20200411,0:00,2020-04-11 10:24,10,1,435
0,NORMAL SERVICE.,2.142477852,503051,487753,3246,7117,2020-04-10 10:15,208,10450,15298,477303,102,20200410,0:00,2020-04-10 10:15,10,1,435
0,NORMAL SERVICE.,2.175074395,494711,479202,3408,6973,2020-04-09 10:22,204,10423,15509,468779,101,20200409,0:00,2020-04-09 10:22,10,1,435
0,NORMAL SERVICE.,2.218116182,486003,468145,3445,6776,2020-04-08 10:15,200,10384,17858,457761,100,20200408,0:00,2020-04-08 10:15,10,1,435
0,NORMAL SERVICE.,2.262325524,477304,456654,3500,6694,2020-04-07 10:12,192,10331,20650,446323,99,20200407,0:00,2020-04-07 10:12,10,1,435
0,NORMAL SERVICE.,2.298054341,466804,447509,3591,6598,2020-04-06 10:27,186,10284,19295,437225,98,20200406,0:00,2020-04-06 10:27,10,1,435
0,NORMAL SERVICE.,2.317835811,461233,441662,3654,6463,2020-04-05 10:11,183,10237,19571,431425,97,20200405,0:00,2020-04-05 10:11,10,1,435
0,NORMAL SERVICE.,2.33531392,455032,434888,3867,6325,2020-04-04 10:32,177,10156,20144,424732,96,20200404,0:00,2020-04-04 10:32,10,1,435
0,NORMAL SERVICE.,2.371072072,443273,424365,3979,6021,2020-04-03 10:19,174,10062,18908,414303,95,20200403,0:00,2020-04-03 10:19,10,1,435
0,NORMAL SERVICE.,2.410488622,431743,413858,4155,5828,2020-04-02 10:13,169,9976,17885,403882,94,20200402,0:00,2020-04-02 10:13,10,1,435
0,NORMAL SERVICE.,2.441463644,421547,404962,4216,5567,2020-04-01 10:13,165,9887,16585,395075,92,20200401,0:00,2020-04-01 10:13,10,1,435
0,NORMAL SERVICE.,2.485825763,410564,393672,4275,5408,2020-03-31 11:00,162,9786,16892,383886,91,20200331,0:00,2020-03-31 11:00,10,1,435
0,NORMAL SERVICE.,2.531290694,395194,381663,4398,5228,2020-03-30 10:32,158,9661,13531,372002,90,20200330,0:00,2020-03-30 10:32,10,1,435
0,NORMAL SERVICE.,2.527742388,394141,379113,4523,5033,2020-03-29 10:10,152,9583,15028,369530,89,20200329,0:00,2020-03-29 10:10,10,1,435
0,NORMAL SERVICE.,2.552233541,387925,371361,4665,4811,2020-03-28 10:30,144,9478,16564,361883,88,20200328,0:00,2020-03-28 10:30,10,1,435
0,NORMAL SERVICE.,2.579739151,376961,361742,4966,4528,2020-03-27 10:17,139,9332,15219,352410,87,20200327,0:00,2020-03-27 10:17,10,1,435
0,NORMAL SERVICE.,2.635970254,364942,350573,5281,4144,2020-03-26 10:40,131,9241,14369,341332,86,20200326,0:00,2020-03-26 10:40,10,1,435
0,NORMAL SERVICE.,2.659057442,357896,343618,5410,3730,2020-03-25 10:12,126,9137,14278,334481,85,20200325,0:00,2020-03-25 10:12,10,1,435
0,NORMAL SERVICE.,2.712657065,348582,333142,5684,3507,2020-03-24 10:20,120,9037,15440,324105,84,20200324,0:00,2020-03-24 10:20,10,1,435
0,NORMAL SERVICE.,2.762262336,338036,324408,5884,3166,2020-03-23 10:27,111,8961,13628,315447,82,20200323,0:00,2020-03-23 10:27,10,1,435
0,NORMAL SERVICE.,2.804501324,331780,317240,6085,2909,2020-03-22 10:07,104,8897,14540,308343,81,20200322,0:00,2020-03-22 10:07,10,1,435
0,NORMAL SERVICE.,2.82195603,327509,311805,6325,2612,2020-03-21 10:02,102,8799,15704,303006,80,20200321,0:00,2020-03-21 10:02,10,1,435
0,NORMAL SERVICE.,2.873091828,316664,301139,6527,2233,2020-03-20 10:15,94,8652,15525,292487,79,20200320,0:00,2020-03-20 10:15,10,1,435
0,NORMAL SERVICE.,2.942085738,307024,291120,6789,1947,2020-03-19 10:07,91,8565,15904,282555,78,20200319,0:00,2020-03-19 10:07,10,1,435
0,NORMAL SERVICE.,3.012162506,295647,279301,6838,1540,2020-03-18 10:26,84,8413,16346,270888,77,20200318,0:00,2020-03-18 10:26,10,1,435
0,NORMAL SERVICE.,3.088057901,286716,269425,7024,1401,2020-03-17 10:29,81,8320,17291,261105,76,20200317,0:00,2020-03-17 10:29,10,1,435
0,NORMAL SERVICE.,3.173392208,274504,259533,7253,1137,2020-03-16 10:12,75,8236,14971,251297,75,20200316,0:00,2020-03-16 10:12,10,1,435
0,NORMAL SERVICE.,3.239660236,268212,251940,7300,834,2020-03-15 10:01,75,8162,16272,243778,74,20200315,0:00,2020-03-15 10:01,10,1,435
0,NORMAL SERVICE.,3.318000336,261335,243701,7402,714,2020-03-14 10:29,72,8086,17634,235615,73,20200314,0:00,2020-03-14 10:29,10,1,435
0,NORMAL SERVICE.,3.458499309,248647,230707,7470,510,2020-03-13 10:07,67,7979,17940,222728,72,20200313,0:00,2020-03-13 10:07,10,1,435
0,NORMAL SERVICE.,3.621744273,234998,217271,7407,333,2020-03-12 10:37,66,7869,17727,209402,71,20200312,0:00,2020-03-12 10:37,10,1,435
0,NORMAL SERVICE.,3.804174536,222395,203855,7212,288,2020-03-11 10:17,60,7755,18540,196100,70,20200311,0:00,2020-03-11 10:17,10,1,435
0,NORMAL SERVICE.,3.919308057,210144,191692,7165,247,2020-03-10 10:20,54,7513,18452,184179,69,20200310,0:00,2020-03-10 10:20,10,1,435
0,NORMAL SERVICE.,4.120339361,196618,179160,6954,166,2020-03-09 10:47,51,7382,17458,171778,68,20200309,0:00,2020-03-09 10:47,10,1,435
0,NORMAL SERVICE.,4.21775786,188518,169142,6605,130,2020-03-08 11:16,50,7134,19376,162008,67,20200308,0:00,2020-03-08 11:16,10,1,435
0,NORMAL SERVICE.,4.267542836,178189,158569,6134,118,2020-03-07 11:00,44,6767,19620,151802,66,20200307,0:00,2020-03-07 11:00,10,1,435
0,NORMAL SERVICE.,4.397234584,164740,142908,5643,108,2020-03-06 12:55,42,6284,21832,136624,65,20200306,0:00,2020-03-06 12:55,10,1,435
0,NORMAL SERVICE.,4.622748154,146541,124731,5255,88,2020-03-05 10:15,35,5766,21810,118965,64,20200305,0:00,2020-03-05 10:15,10,1,435
0,NORMAL SERVICE.,4.919985595,136707,108293,4750,41,2020-03-04 10:21,32,5328,28414,102965,63,20200304,0:00,2020-03-04 10:21,10,1,435
0,NORMAL SERVICE.,5.329139718,125851,90296,4159,34,2020-03-03 10:46,28,4812,35555,85484,62,20200303,0:00,2020-03-03 10:46,10,1,435
0,NORMAL SERVICE.,5.557314756,109591,75792,,31,2020-03-02 10:52,22,4212,33799,71580,61,20200302,0:00,2020-03-02 10:52,10,1,435
0,NORMAL SERVICE.,,,,,30,2020-03-01 17:41,18,3736,33360,,60,20200301,16:00,2020-03-01 17:41,10,1,435
0,NORMAL SERVICE.,,,,,28,2020-02-29 17:16,17,3150,35182,,58,20200229,16:00,2020-02-29 17:16,10,1,435
0,NORMAL SERVICE.,,,,,27,2020-02-28 17:01,13,2337,30237,,56,20200228,16:00,2020-02-28 17:01,10,1,435
0,NORMAL SERVICE.,,,,,26,2020-02-27 17:32,13,1766,25568,,54,20200227,16:00,2020-02-27 17:32,10,1,435
0,NORMAL SERVICE.,,,,,24,2020-02-26 17:00,12,1261,20716,,52,20200226,16:00,2020-02-26 17:00,10,1,435
0,NORMAL SERVICE.,,,,,22,2020-02-25 17:02,10,977,13880,,50,20200225,16:00,2020-02-25 17:02,10,1,435
0,NORMAL SERVICE.,,,,,22,2020-02-24 17:03,7,833,11631,,48,20200224,16:00,2020-02-24 17:03,10,1,435
0,NORMAL SERVICE.,,,,,18,2020-02-23 17:05,5,602,8057,,46,20200223,16:00,2020-02-23 17:05,10,1,435
0,NORMAL SERVICE.,,,,,18,2020-02-22 17:00,2,433,6037,,44,20200222,16:00,2020-02-22 17:00,10,1,435
0,NORMAL SERVICE.,,,,,17,2020-02-21 17:13,1,204,3180,,42,20200221,16:00,2020-02-21 17:13,10,1,435
0,NORMAL SERVICE.,,,,,16,2020-02-20 17:12,1,104,1860,,39,20200220,16:00,2020-02-20 17:12,10,1,435
0,NORMAL SERVICE.,,,,,16,2020-02-19 17:00,0,51,1149,,37,20200219,16:00,2020-02-19 17:00,10,1,435
0,NORMAL SERVICE.,,,,,12,2020-02-18 16:42,0,31,818,,35,20200218,16:00,2020-02-18 16:42,10,1,435
0,NORMAL SERVICE.,,,,,10,2020-02-17 16:50,0,30,708,,32,20200217,16:00,2020-02-17 16:50,10,1,435
0,NORMAL SERVICE.,,,,,9,2020-02-16 16:57,0,29,485,,30,20200216,16:00,2020-02-16 16:57,10,1,435
0,NORMAL SERVICE.,,,,,9,2020-02-15 17:00,0,28,558,,28,20200215,16:00,2020-02-15 17:00,10,1,435
0,NORMAL SERVICE.,,,,,7,2020-02-14 17:16,0,28,535,,26,20200214,16:00,2020-02-14 17:16,10,1,435
0,NORMAL SERVICE.,,,,,7,2020-02-13 17:09,0,28,562,,24,20200213,16:00,2020-02-13 17:09,10,1,435
0,NORMAL SERVICE.,,,,,7,2020-02-12 16:56,0,28,785,,22,20200212,16:00,2020-02-12 16:56,10,1,435
0,NORMAL SERVICE.,,,,,4,2020-02-11 17:09,0,28,762,,20,20200211,16:00,2020-02-11 17:09,10,1,435
0,NORMAL SERVICE.,,,,,3,2020-02-10 17:03,0,27,531,,18,20200210,16:00,2020-02-10 17:03,10,1,435
0,NORMAL SERVICE.,,,,,3,2020-02-09 16:59,0,27,888,,16,20200209,16:00,2020-02-09 16:59,10,1,435
0,NORMAL SERVICE.,,,,,2,2020-02-08 17:01,0,24,939,,14,20200208,16:00,2020-02-08 17:01,10,1,435
0,NORMAL SERVICE.,,,,,2,2020-02-07 17:20,0,24,327,,9,20200207,16:00,2020-02-07 17:20,10,1,435
0,NORMAL SERVICE.,,,,,1,2020-02-06 9:09,0,23,169,,7,20200206,9:00,2020-02-06 9:09,10,1,435
0,NORMAL SERVICE.,,,,,1,2020-02-05 20:05,0,19,40,,6,20200205,19:00,2020-02-05 20:05,10,1,435
0,NORMAL SERVICE.,,,,,0,2020-02-03 21:26,0,0,0,,4,20200204,0:00,2020-02-03 21:26,10,1,435
0,NORMAL SERVICE.,,,,,0,2020-02-03 14:41,0,15,0,,3,20200203,9:00,2020-02-03 14:41,10,1,435
0,NORMAL SERVICE.,,,,,2,2020-02-03 12:22,2,2,2,,2,20200202,9:00,2020-02-03 12:22,10,1,435
0,NORMAL SERVICE.,,,,,1,2020-01-31 17:47,0,0,1,,1,20200201,18:00,2020-01-31 17:47,10,1,435
0,NORMAL SERVICE.,,,,,1,2020-01-31 17:47,0,0,1,,1,20200101,18:00,2020-02-03 12:21,10,1,435
